Ms, Ms, Ms, Ms^Fpa, Ms^Fpa, Ms, Ms^Fpa, Ms, Ms, Ms, Ms, Mm, Ms, Mm, Ms, Mm, Mm, Mm, Ha^Fpa, Ha, Ms, Ms, Ms, Mm, Mm, Gg, Mm, Gg, Mm, Mm, Hh^Qhh, Gg, Hh^Qhhf, Hh^Qhhf, Hh^Qhhf, Gg^Fms, Hh, Hh, Hh, Gg, Gs^Fms, Gg^Fms
Ms, Ms, Ms, Ms^Fpa, Ms^Fpa, Ms, Ms, Ha, Mm^Fpa, Mm, Ms, Mm, Ha, Ms, Ha^Fpa, Mm, Hh^Es, Mm, Ww^Wkf, Hh^Fpa, Mm, Ms, Mm, Ha, Mm^Fpa, Mm, Ms, Mm, Mm^Fpa, Mm, Hh^Fms, Hh^Fp, Hh^Fms, Hh^Qhhf, Hh^Qhh, Hh^Qhh, Gg, Gg^Fms, Hh, Gg, Gg, Gg
Ms, Ms, Ms, Ms, Ms, Ms, Ms, Ms, Mm, Ha^Fpa, Mm, Mm, Ms, Ms, Ms, Ha^Fpa, Mm, Wwr, Mm, Wwr, Wo, Hh^Fpa, Hh, Ms, Ms, Hh, Mm, Mm, Mm, Mm, Hh, Hh^Fp, Gg^Fms, Hh^Qhh, Hh, Hh^Qhhf, Hh, Gg, Gg^Fms, Gg, Hh^Fms, Hh
Ha, Ms, Ms, Ha^Fpa, Mm, Ms, Mm, Mm^Fpa, Ms, Mm, Ms, Mm, Ha^Fpa, Ms, Mm, Mm, Mm, Mm, Hh^Fp, Mm, Ww^Wkf, Ww^Ewf, Hh^Fetd, Mm, Mm, Hh, Hh^Fms, Mm, Mm, Hh^Fp, Hh^Qhhf, Hh^Fms, Gg^Qhhf, Hh, Hh^Fms, Gg^Fms, Hh^Fms, Hh, Gg, Gg^Es, Gs, Hh
Mm, Mm^Fpa, Ms, Ha, Mm^Fpa, Ms, Hh^Fpa, Ha, Mm, Mm, Mm, Ms, Hh^Fms, Hh, Mm, Mm, Hh^Es, Hh^Fp, Hh^Fms, Hh, Hh^Fms, Wwr, Hh^Fms, Mm^Fpa, Mm, Mm, Gg^Es, Hh, Gg^Es, Hh, Hh, Hh^Fms, Hh, Hh, Hh^Es, Hh, Gg^Es, Hh^Fetd, Gg^Fms, Gg^Edpp, Gs^Efm, Gg^Efm
Ms, Mm, Mm, Mm, Hh^Fp, Mm, Hh, Hh^Fp, Hh^Fms, Mm, Mm, Mm, Hh, Hh, Mm, Hh, Hh, Hh^Fms, Hh, Hh, Ss, Ww^Wkf, Wo, Hh, Hh^Fms, Hh, Gg^Fds, Hh, Gg^Fp, Hh, Gg^Es, Gg^Fms, Hh, Gg, Gg^Efm, Hh, Hh^Fms, Gg, Hh, Gg, Hh, Hh
Mm, Mm^Fpa, Mm^Fpa, Mm, Hh, Hh, Hh^Fp, Gg^Fetd, Hh, Mm, Hh^Fms, Hh, Mm, Ha^Fpa, Mm, Mm, Hh^Ebn, Rb^Vh, Rb, Hh^Fds, Gg, Ww^Ewl, Ww^Wkf, Gg, Ww^Wkf, Wo, Wwr^Wkf, Ww^Wkf, Ds, Gg^Fds, Gg, Gg, Gg, Gg, Gg^Fms, Gg, Gg^Es, Gg, Gg, Gg, Gg^Fms, Gd
Hh, Mm, Hh^Fp, Hh, Gg, Gg^Fms, Gg, Gg^Es, Rb, Hh^Fms, Hh, Mm, Gs, Mm, Gg^Eff, Rp, Rp, Hh^Fds, Rp, Gg, Hh, Ds, Gg, Wwr, Ds, Ww, Ds, Wo, Wwr, Wo, Ds, Gs^Es, Gg, Hh, Gg, Gg^Es, Gg^Fms, Gs^Fms, Gg, Rb, Gs^Edpp, Gs
Hh^Fms, Hh, Hh^Fp, Hh^Fms, Hh^Fms, Gg^Edpp, Gg^Efm, Hh^Fms, Rb, Hh, Hh, Gg^Eff, Gg^Eff, Gg, Gg^Eff, Gg^Eff, Hh^Fds, Rp, Hh^Es, Rb, Rp, Rb, Rp^Vh, Gg, Gg, Ss, Gg^Fms, Ss, Ds, Wo^Wkf, Ss, Gg^Fds, Gg^Efm, Gg, Gs^Fms, Gs, Gg, Gs^Fms, Hh, Rb, Rb, Gd^Efm
Gg, Hh^Fms, Cv, Cv, Cvr, Gg^Es, Hh^Fms, Rp, Gg, Hh^Fms, Gg, Gg^Fms, Gs^Fms, Gg^Eff, Gg^Fds, Gg^Efm, Hh, Gg^Es, Gg^Edpp, Gg, Gs^Fms, Gg, Rp, Gg, Gg^Fms, Gg, Gs, Gg, Wo^Wkf, Ww, Ds, Gg^Fds, Ds, Ds, Gg, Gg^Fms, Gg^Es, Hh, Hh^Es, Hh, Rp, Rb
Gg, Hh^Fms, Gg^Es, Cvr, Kvr, Gg, Rb^Vh, Rb, Gg^Fds, Gg, Gg^Es, Gs^Fms, Gg^Efm, Gg, Gs, Gg, Gg, Gg^Efm, Gg^Fms, Gs, Gg, Gg, Hh, Rb, Rb, Rb, Rp, Ds, Ds, Ww^Wkf, Ds, Wo^Wkf, Ww, Wo^Wkf, Ds, Gg, Gg^Efm, Gg, Gs, Gg^Edpp, Rb, Gg
Gg^Fds, Gg^Efm, Gg^Edb, Cvr, Rb^Gvs, Rb^Gvs, Gs, Rp, Rp, Gg, Rp, Gg^Edpp, Gs, Gg^Es, Gg, Gs^Fds, Gg^Efm, Gg^Es, Gg, Gs, Hh^Fms, Gg^Fms, Gs^Es, Hh, Gg^Es, Rb, Rp^Vh, Gg^Fds, Chr, Wwr, Ww^Wkf, Ww^Ewf, Wo, Ww, Ww^Wkf, Gg^Fds, Gg, Rb^Vh, Gg^Efm, Rb, Gs^Efm, Hh^Efm
Gg, Gg, Cv, Gs, Gg^Fms, Gg, Rb, Rp, Hh, Rb, Hh^Es, Rb, Gs^Fds, Gs, Rb^Vh, Gg, Gg, Gg, Gg^Fds, Gs, Gg, Gg, Rb, Gg, Gs, Rb, Chr, 2 Khr, Chr, Chr, Ds, Chr, Ds, Wwr, Wwr, Ds, Rp, Rb, Rb, Rb, Gg^Fms, Gs
Rb, Gg^Edb, Gg^Efm, Gs, Gg, Gg^Es, Rb, Gg, Hh^Efm, Gg, Gg^Efm, Rb, Rb, Gg, Rb, Rb, Rb, Hh, Hh, Gg, Rb, Rb, Gg^Es, Rb, Gg, Rb, Rb, Chr, Gs, Rb, Gg^Fds, Gg, Ds, Ww^Ewl, Wo, Ds, Rb, Gg^Fds, Gg^Efm, Gs, Gs, Gs
Gg, Rb, Hh, Gg^Fds, Gg^Edb, Hh, Rb, Gd, Gg, Hh^Fds, Gg^Fds, Gg, Hh, Rb, Hh, Hh^Fds, Rp, Gg, Hh, Gs, Rp, Hh^Fds, Gg^Es, Rb, Rb, Gg, Rb, Rb, Rb, Gg, Gg, Gg^Fds, Wo, Ww^Wkf, Rp, Rp, Gg^Fds, Ds, Gg^Fds, Gs^Es, Gd, Gd^Fds
Gs, Rb, Rb, Hh, Gs^Es, Rp, Rp^Vh, Gs^Fds, Gd^Efm, Gs, Gs, Gg, Gs^Es, Gs, Gg^Efm, Hh, Gg, Rb, Rb, Rb, Hh, Hh, Gg^Fds, Hh, Gg^Es, Rb, Gg^Fds, Gg, Chr, Rp, Gg, Gg^Efm, Ww^Bsb/, Ww^Bsb/, Ds^Efs, Gg, Ds, Ds, Ww^Wkf, Ds, Ds, Gg
Gs, Gs^Fds, Rb, Gs^Efm, Rb, Rb, Hh, Gg, Gd^Es, Gs^Edpp, Gs, Gg^Es, Gs, Gg, Gs, Hh, Gs, Gs^Fds, Gs, Re, Gg^Efm, Gs, Gs, Hh, Gs, Gs, Rb^Gvs, Gs, Gs, Rb, Rp, Rp^Efs, Ds^Efs, Wwr, Wwr^Wkf, Ds, Wo^Wkf, Ds, Ww, Ww^Ewl, Ww^Wkf, Gg^Fds
Gg, Gs, Rb^Efm, Rb, Gs^Edpp, Gs, Ds, Gs^Efm, Gd, Gs, Hhd^Fmw, Hh, Gs, Gd, Gs^Es, Gg^Efm, Gs, Gg, Re, Re, Gs, Gs, Gs^Efm, Gs, Gs, Rb^Gvs, Rb^Gvs, Rb^Gvs, Rb^Vh, Rb, Ds, Ds, Ww^Wkf, Wwr, Ww, Ww^Ewl, Wo, Ww^Wkf, Ww^Ewf, Wo, Ds, Gg^Fds
Gs, Rb^Es, Gs^Edpp, Gd, Hhd, Gg, Gd, Hhd, Gd, Gd^Fmw, Hhd, Hhd^Es, Ds, Gd^Fmw, Gs^Edpp, Gs, Gs, Rb^Vh, Re, Gs, Gs, Hh, Gd, Hh, Gs^Edp, Gs, Gs, Gg^Fms, Gg, Gg, Gg, Ds, Wo^Ewf, Wo, Wo^Wkf, Wo^Wkf, Wo, Wo, Ww, Ww^Ewl, Gg^Es, Gg
Hh, Re^Es, Gs^Fmw, Gs, Gs^Fmw, Hhd^Fmw, Ds^Fetd, Ds^Dr, Ds, Ds^Edpp, Hhd, Gd^Fetd, Dd, Gd, Gd, Gs, Ds, Rb, Rb, Gs^Efm, Gd^Fmw, Gd, Gs^Es, Gs, Gs, Gs, Gs^Efm, Gg, Hh, Gg^Fds, Gg, Wo^Ewf, Ww^Wkf, Wo, Wo, Wo, Wo, Ww^Wkf, Ww^Wkf, Ds, Gg^Fms, Ds
Hh, Re, Re, Hhd, Md, Md, Hhd^Fmw, Hhd, Dd, Gd, Ds^Dr, Ds, Ds, Ds, Hhd, Gd^Fmw, Ds, Gd^Edpp, Re, Gd, Gd, Gd, Gd^Efm, Hh, Gd^Efm, Gg, Gg, Hh^Fds, Gs^Fms, Ds, Ds, Ds, Ww^Ewl, Ww, Wo^Wkf, Ww, Ww, Ww^Wkf, Ds, Ds, Ds, Gg
Gd, Re^Vh, Gd^Fmw, Gd, Hhd, Md, Ds^Dr, Hhd, Ds^Edpp, Ds, Hhd, Hhd, Ds, Gd, Dd, Ds^Dr, Gd^Fetd, Re, Gd, Ds, Gd, Ds, Gd^Fmw, Gd, Gs, Gs, Hh, Gs, Gg^Fms, Gg^Fds, Gg^Fds, Ds, Ds, Ww^Wkf, Ds, Ww^Ewf, Ds, Wwr, Wo^Ewl, Ds, Ds, Gg
Gd, Gd, Dd, Gd, Ds^Edpp, Hhd, Gd^Fetd, Hhd, Ds, Gd^Fmw, Hhd, Ds, Hhd, Ds, Ds^Edpp, Ds^Edp, Cer, Re, Gd^Edpp, Gd, Ds^Edpp, Ds, Gd^Edpp, Gs, Gs, Rb^Vh, Gg, Gs^Efm, Hh, Hh, Gs^Fms, Ds, Gg^Fds, Ds, Gg, Ds, Ds, Ww, Ww, Ds, Ww^Wkf, Ds
Gd, Ds, Ds, Ds^Edb, Re^Efm, Re, Re, Re, Re, Ds^Edpp, Gd, Ds, Re, Ds, Cer^Edb, Dd^Do, Cer^Edb, Ds, Gd, Gd, Ds, Ds, Gd, Gs^Fmw, Gs^Fmw, Rb, Gd^Es, Gs, Hh, Hh^Es, Gs, Hh, Gd, Ds, Gg^Fms, Gg^Fds, Ds, Wo^Wkf, Ww^Wkf, Wwr, Wwr, Ww
Gd, Gd^Fetd, Ds, Gd, Re, Ds, Ds^Dc, Dd, Ds^Edp, Re, Re^Vdt, Re, Dd^Eff, Cer^Edpp, Cer^Edpp, 1 Ker, Cer^Edb, Cer^Edb, Ds, Ds, Gd, Gd, Gd^Fmw, Gs, Rb, Rb, Gs, Gs, Gs^Edpp, Hh, Gg^Efm, Gg, Gg^Fds, Gs, Gs^Vh, Gg, Gg^Fds, Ds, Ds, Ds, Ds, Ww
Ds, Ds^Edb, Ds, Re, Ds, Ds, Ds, Ds^Edp, Dd, Ds^Efs, Ds, Dd^Eff, Dd^Eff, Ds^Edb, Dd^Ebn, Re, Ds^Dr, Ds, Dd^Edp, Ds, Ds^Edb, Ds, Ds, Rb^Vdt, Ds, Gd^Edpp, Hh, Gs, Gg, Gg, Gg, Gs^Efm, Hh, Gg^Fds, Gs, Ds^Efs, Chr, Ds, Gs^Fds, Gg^Es, Ds, Wo
Ds, Gd, Ds, Re, Re, Gd, Ds^Qhh, Ds^Edp, Dd, Ds^Qhh, Uh^Dr, Ds^Edp, Ds^Edp, Ds^Edb, Dd, Re, Re^Vdt, Dd, Ds, Dd, Dd, Ds, Mdd, Rb, Ds, Gd, Hh, Gs, Gs^Vh, Gs^Efm, Gg, Hh, Gg^Fds, Gg^Fds, Gd, Ch, Khr, Ch, Gs^Es, Ds, Ds, Ds
Ds, Ds^Edp, Dd, Ds, Ds^Dc, Ds^Dr, Ds, Dd, Dd^Qhh, Uh^Dr, Hhd, Ds^Qhh, Uh^Dr, Dd, Dd, Dd, Ds^Dr, Ds, Ds, Mdd, Mdd, Ds^Qhh, Mdd, Dd^Dr, Ds, Gd^Fetd, Gs^Fmw, Gs, Gs^Edpp, Gs, Gs^Edpp, Hh, Gs, Gd^Efm, Gs, Ch, Ch, Chr, Hh, Gg^Efm, Gg^Efm, Gg
Dd, Ds^Edp, Dd^Qhh, Ds^Edb, Dd^Edp, Ds, Dd^Qhh, Hhd, Mdd, Mdd, Dd^Edp, Mdd, Ds^Qhh, Dd, Mdd, Ds^Qhh, Ds^Qhh, Dd^Edpp, Ds^Edpp, Ds, Dd^Edp, Dd^Do, Dd^Edp, Dd, Ds, Ds^Edb, Gd, Gd, Hh^Edpp, Hh, Gs, Gg^Es, Hh, Hh, Gg, Gg, Gs^Es, Gd^Efm, Gg, Gd, Hh, Gg^Es
Ds, Ds^Qhh, Ds^Qhh, Ds^Edpp, Ds^Dr, Hhd, Mdd, Ds^Qhh, Mdd, Mdd, Hhd, Hhd, Mdd, Mdd, Hhd, Hhd, Mdd, Ds^Dc, Hhd, Dd, Ds, Ds^Edp, Ds, Ds^Edpp, Ds, Ds^Edp, Gg, Gd, Gg, Gg, Gg, Hh, Gg, Hh, Gg, Hh, Gg, Gg^Es, Gg, Gg, Gg, Gg
