Xu, Xu, Xu, Xu, Xu, Ww, Ww, Ww, Xu, Xu, Xu, Xu, Xu, Xu, Xu, Xu, Xu, Xu, Xu, Xu, Xu, Xu, Xu, Xu, Xu, Xu, Xu, Xu, Xu, Xu, Xu, Xu
Xu, Xu, Xu, Xu, Xu, Ww, Ww^Bw|r, Ww, Xu, Xu, Xu, Xu, Xu, Xu, Xu, Xu, Xu, Xu, Xu, Xu, Xu, Xu, Xu, Xu, Xu, Xu, Xu, Xu, Xu, Xu, Xu, Xu
Xu, Xu, Xu, Xu, Xu, Uhe, Uu, Uue, Xu^Efs, Qxua, Xu, Xu, Xu, Xu, Xu, Xu, Xu, Xu, Xu, Xu, Xu, Xu, Xu, Xu, Xu, Xu, Xu, Xu, Xu, Xu, Xu, Xu
Xu, Xu, Xu, Xu, Qxua, Ur, Uue, Uue, Ur, Qxua, Qxua, Xu^Efs, Xu, Xu, Xu, Xu, Xu, Xu, Xu, Xu, Xu, Xu, Xu, Xu, Xu, Xu, Xu, Xu, Xu, Xu, Xu, Xu
Xu, Xu, Xu, Xu, Qxua, Uu^Emf, Ur, Uhe, Uh, Uu, Uh^Emf, Uh^Tf, Uu^Vu, Xu, Xu^Efs, Xu, Xu, Xu, Xu, Xu, Xu, Xu, Xu, Xu, Xu, Xu, Xu, Xu, Xu, Xu, Xu, Xu
Xu, Xu, Xu, Xu, Xu, Qxua, Xu, Uu, Uh, Uh^Tf, Cud, Uu, Uu, Uu, Uue, Xu^Efs, Xu, Xu, Xu, Xu, Xu, Xu, Xu, Xu, Xu, Xu, Xu, Xu, Xu, Xu, Xu, Xu
Xu, Xu, Xu, Xu, Xu, Xu, Xu, Xu, Xu, Cud, 2 Kud, Cud, Uh^Tf, Uue, Uue, Uhe^Emf, Ur, Qxua, Qxua, Xu, Xu, Xu, Xu, Xu, Xu, Xu, Xu, Xu, Xu, Xu, Xu, Xu
Xu, Xu, Xu, Xu, Xu, Xu, Xu, Xu, Xu, Cud, Cud, Cud, Xu, Uh, Uue, Uhe, Uh, Uue, Uu, Qxua, Xu^Efs, Xu, Xu^Efs, Xu, Xu, Xu, Xu, Xu, Xu, Xu, Xu, Xu
Xu, Xu, Xu, Xu, Xu, Xu, Xu, Xu, Xu, Xu, Xu, Xu, Xu, Xu, Xu, Uu, Uue, Uhe, Ur, Xu, Cud, Cud, Cud, Xu^Efs, Xu, Qxua, Xu, Xu, Xu, Xu, Xu, Xu
Xu, Xu, Xu, Xu, Xu, Xu, Xu, Xu, Xu, Xu, Xu, Qxua, Qxua, Xu, Xu, Qxua, Uue, Uue, Uu, Uue, Cud, 3 Kud, Cud, Uu, Uu, Qxua, Xu, Qxua, Xu, Xu, Xu, Xu
Xu, Xu, Xu, Xu, Xu, Xu, Xu, Xu, Xu^Efs, Xu^Efs, Uue, Ur, Uu^Vud, Xu^Efs, Qxua, Qxua, Ur, Uu, Uu^Vu, Uue, Uue, Cud, Uh, Ur, Ur, Uu^Vud, Uh, Qxua, Qxua, Xu, Xu, Xu
Xu, Xu, Xu, Xu, Xu, Qxua, Xu^Efs, Xu, Uue, Uh^Emf, Ur^Emf, Ur, Uue, Ur, Uh, Ur, Uh, Uu, Uh, Uu, Qxua, Qxua, Qxua, Uh^Emf, Uh^Tf, Uu, Uu, Uh^Emf, Qxua, Xu, Xu, Xu
Xu, Xu, Xu, Xu, Qxua, Qxua, Uh, Uue, Uu, Uh^Tf, Uh, Uu, Uu, Uue, Ur, Ur, Uu, Uh^Emf, Xu, Xu, Xu, Xu, Xu, Xu, Qxua, Uue, Ur, Uh, Qxua, Xu, Xu, Xu
Xu, Xu, Xu, Xu, Xu, Xu, Uhe^Tf, Uue, Uu^Vud, Ur, Qxua, Qxua, Xu, Uue, Uue, Uhe, Uh^Tf, Xu, Xu, Xu, Xu, Xu, Xu, Xu, Qxua, Uue, Uhe, Uue, Xu, Xu, Xu, Xu
Xu, Xu, Xu, Xu, Xu, Xu, Uh, Ur, Uu, Xu, Xu, Qxua, Xu, Xu, Uh, Uue^Emf, Ur, Xu, Xu, Xu, Xu, Xu, Xu, Xu, Qxua, Uhe, Uhe, Ur, Xu, Xu, Xu, Xu
Xu, Xu, Xu, Xu, Xu, Qxua, Uhe, Ur, Uue, Xu, Xu, Xu, Xu, Xu, Qxua, Ur, Uu^Vu, Qxua, Xu, Xu, Xu, Xu, Xu^Efs, Qxua, Uh^Tf, Uh^Emf, Ur, Ur, Qxua, Xu, Xu, Xu
Xu, Xu, Xu, Xu, Xu, Qxua, Uhe, Uue, Uue^Tf, Xu, Xu, Xu, Xu, Qxua, Ur, Ur, Ur, Qxua, Qxua, Xu, Qxua, Xu^Efs, Uu^Vud, Uu, Ur, Uu, Uue, Uue, Qxua, Qxua, Xu, Xu
Xu, Xu, Xu, Xu, Xu, Qxua, Qxua, Uhe^Emf, Xu, Xu, Xu, Xu, Xu, Qxua, Ur, Uhe, Uu, Uu^Emf, Uhe, Qxua, Uue, Uue, Ur, Ur, Uh^Tf, Uu, Ur, Uue, Qxua, Xu, Xu, Xu
Xu, Xu, Xu, Xu, Xu, Xu, Xu, Xu, Xu, Xu, Xu, Xu, Xu, Xu, Xu, Uh, Uh^Tf, Uue, Uue, Uhe, Uue, Uu, Uh, Uu, Qxua, Uh^Emf, Cud, Uh, Xu, Xu, Xu, Xu
Xu, Xu, Xu, Xu, Xu, Xu, Xu, Xu, Xu, Xu, Xu, Xu, Xu, Xu, Xu, Xu, Qxua, Uu, Uu^Vud, Ur, Uu, Uu, Qxua, Qxua, Xu, Cud, 1 Kud, Cud, Xu, Xu, Xu, Xu
Xu, Xu, Xu, Xu, Xu, Xu, Xu, Xu, Xu, Xu, Xu, Xu, Xu, Xu, Xu, Xu, Xu, Qxua, Qxua, Qxua, Qxua, Xu, Xu, Xu, Xu, Cud, Cud, Cud, Xu, Xu, Xu, Xu
Xu, Xu, Xu, Xu, Xu, Xu, Xu, Xu, Xu, Xu, Xu, Xu, Xu, Xu, Xu, Xu, Xu, Xu, Xu, Xu, Xu, Xu, Xu, Xu, Xu, Uue, Ur, Uh, Xu, Xu, Xu, Xu
